AFG	AFG
ALB	ALB
DZA	ALG
ASM	ASM
AND	AND
AGO	ANG
AIA	AIA
ATA	ATA
ATG	ANT
ARG	ARG
ARM	ARM
ABW	ABW
AUS	AUL
AUT	AUS
AZE	AZE
BHS	BHS
BHR	BAH
BGD	BGD
BRB	BAR
BLR	BLR
BEL	BEL
BLZ	BZE
BEN	BEN
BMU	BER
BTN	BHU
BOL	BOL
BIH	BSN
BWA	BOT
BVT	BVT
BRA	BRA
IOT	IOT
BRN	BRU
BGR	BUL
BFA	BKF
BDI	BDI
CPV	CVI
KHM	CAM
CMR	CMR
CAN	CAN
CYM	CAY
CAF	CAR
TCD	CHD
CHL	CHL
CHN	CHI
CXR	CXR
CCK	CCK
COL	COL
COM	COI
COG	COB
COD	COD
COK	COK
CRI	COS
CIV	ICO
HRV	HRV
CUB	CUB
CUW	CUW
CYP	CYP
CZE	CZE
DNK	DEN
DJI	DJB
DMA	DMA
DOM	DOM
ECU	ECU
EGY	ARE
SLV	SAL
GNQ	EGU
ERI	ERT
EST	EST
SWZ	SWA
ETH	ETH
FLK	FLK
FRO	FRO
FJI	FIJ
FIN	FIN
FRA	FRA
GUF	FGU
PYF	FPO
ATF	ATF
GAB	GAB
GMB	GAM
GEO	GEO
DEU	GFR
GHA	GHA
GIB	GIB
GRC	GRE
GRL	GRL
GRD	GRN
GUM	GUM
GTM	GUA
GIN	GUI
GNB	GNB
GUY	GUY
HTI	HAI
HMD	HMD
HND	HON
HKG	HKG
HUN	HUN
ISL	ICE
IND	IND
IDN	INS
IRN	IRN
IRQ	IRQ
IRL	IRE
ISR	ISR
ITA	ITA
JAM	JAM
JPN	JPN
JOR	JOR
KAZ	KAZ
KEN	KEN
KIR	KIR
KWT	KUW
KGZ	KGZ
LAO	LAO
LVA	LVA
LBN	LEB
LSO	LES
LBR	LBR
LBY	LBY
LIE	LIE
LTU	LTU
LUX	LUX
MAC	MAC
MDG	MAD
MWI	MLW
MYS	MLS
MDV	MDV
MLI	MLI
MLT	MTA
MHL	MHL
MTQ	MAR
MRT	MAU
MUS	MTS
MYT	MYT
MEX	MEX
FSM	FSM
MDA	MDA
MCO	MCO
MNG	MNG
MNE	MNE
MSR	MSR
MAR	MOR
MOZ	MOZ
MMR	MYA
NAM	NAM
NRU	NRU
NPL	NEP
NLD	NET
NCL	NCL
NZL	NZL
NIC	NIC
NER	NGR
NGA	NIG
NIU	NIU
NFK	NFK
PRK	KRN
MKD	MCD
MNP	MNP
NOR	NOR
OMN	OMN
PAK	PAK
PLW	PLW
PSE	PAL
PAN	PAN
PNG	PNG
PRY	PAR
PER	PER
PHL	PHI
PCN	PCN
POL	POL
PRT	POR
PRI	PUE
QAT	QAT
REU	REU
ROU	ROM
RUS	RUS
RWA	RWA
SHN	SHN
KNA	KNA
LCA	LCA
SPM	SPM
VCT	VCT
WSM	WES
SMR	SMA
STP	STP
SAU	SAU
SEN	SEN
SRB	SER
SYC	SEY
SLE	SLE
SGP	SIN
SXM	SXM
SVK	SVK
SVN	SVN
SLB	SOL
SOM	SOM
ZAF	RSA
SGS	SGS
KOR	KOR
SSD	SSD
ESP	SPA
LKA	LKA
SDN	SUD
SUR	SUR
SJM	SJM
SWE	SWE
CHE	SWI
SYR	SYR
TWN	TWN
TJK	TJK
TZA	TAN
THA	THA
TLS	TMP
TGO	TOG
TKL	TKL
TON	TON
TTO	TRT
TUN	TUN
TUR	TUR
TKM	TKM
TCA	TCI
TUV	TUV
UGA	UGA
UKR	UKR
ARE	UAE
GBR	GBR
UMI	UMI
USA	USA
U	U
URY	URU
UZB	UZB
VUT	VUT
VEN	VEN
VNM	SRV
VGB	VGB
VIR	VIR
WLF	WLF
ESH	WSH
YEM	YEM
ZMB	ZAM
ZWE	ZIM
